for reference:

Parameter	Description
--help, -h	Get list of available parameters.
--version, -v	Get OBS version.*
--startstreaming	Automatically start streaming.
--startrecording	Automatically start recording.
--startvirtualcam	Automatically start virtual camera.
--startreplaybuffer	Automatically start Replay Buffer.
--collection "name"	Start with given scene collection.
--profile "name"	Start with given profile.
--scene "name"	Start with given scene.
--studio-mode	Start with Studio Mode active.
--minimize-to-tray	Start minimized to system tray.
--portable, -p	Use portable mode.
--multi, -m	Don't warn when launching multiple instances.
--always-on-top	Start in 'always on top' mode.
--verbose	Make log more verbose.
--unfiltered_log	Disable log filter (do not suppress repeated lines).
--disable-updater	Disable built-in updater (Windows/macOS only).
--allow-opengl	Allow OpenGL renderer on Windows.
--disable-missing-files-check	Disable missing file check dialog on startup



C:\Users\Fauzaanu\Desktop\OBS_AUTO_RECORD\venv\Scripts\python.exe C:/Users/Fauzaanu/Desktop/OBS_AUTO_RECORD/test.py
['system idle process', 'system', 'registry', 'dwm.exe', 'conhost.exe', 'fontdrvhost.exe', 'smss.exe', 'dllhost.exe', 'svchost.exe', 'fontdrvhost.exe', 'svchost.exe', 'csrss.exe', 'wininit.exe', 'jcef_helper.exe', 'services.exe', 'lsass.exe', 'svchost.exe', 'svchost.exe', 'brave.exe', 'python.exe', 'svchost.exe', 'conhost.exe', 'adobecollabsync.exe', 'svchost.exe', 'svchost.exe', 'svchost.exe', 'svchost.exe', 'svchost.exe', 'svchost.exe', 'svchost.exe', 'csrss.exe', 'svchost.exe', 'svchost.exe', 'svchost.exe', 'svchost.exe', 'svchost.exe', 'nvdisplay.container.exe', 'svchost.exe', 'chromedriver.exe', 'svchost.exe', 'svchost.exe', 'svchost.exe', 'svchost.exe', 'cephtmlengine.exe', 'svchost.exe', 'svchost.exe', 'svchost.exe', 'spoolsv.exe', 'svchost.exe', 'svchost.exe', 'svchost.exe', 'svchost.exe', 'svchost.exe', 'svchost.exe', 'svchost.exe', 'svchost.exe', 'python.exe', 'adobe installer.exe', 'svchost.exe', 'svchost.exe', 'svchost.exe', 'svchost.exe', 'svchost.exe', 'svchost.exe', 'svchost.exe', 'illustrator.exe', 'cephtmlengine.exe', 'unsecapp.exe', 'svchost.exe', 'svchost.exe', 'svchost.exe', 'svchost.exe', 'svchost.exe', 'svchost.exe', 'nvcontainer.exe', 'armsvc.exe', 'wtabletservicepro.exe', 'adobeupdateservice.exe', 'wmiregistrationservice.exe', 'msmpeng.exe', 'agsservice.exe', 'agmservice.exe', 'svchost.exe', 'fsnotifier.exe', 'jhi_service.exe', 'cephtmlengine.exe', 'svchost.exe', 'svchost.exe', 'conhost.exe', 'svchost.exe', 'aggregatorhost.exe', 'ccxprocess.exe', 'nissrv.exe', 'brave.exe', 'svchost.exe', 'svchost.exe', 'sppsvc.exe', 'svchost.exe', 'svchost.exe', 'steam.exe', 'chromedriver.exe', 'svchost.exe', 'wacomhost.exe', 'jcef_helper.exe', 'steamservice.exe', 'svchost.exe', 'creative cloud.exe', 'memcompression', 'googlecrashhandler.exe', 'steamwebhelper.exe', 'shellexperiencehost.exe', 'svchost.exe', 'nvidia web helper.exe', 'msedgewebview2.exe', 'conhost.exe', 'lockapp.exe', 'viber.exe', 'yourphone.exe', 'svchost.exe', 'securityhealthservice.exe', 'bravecrashhandler.exe', 'discord.exe', 'securityhealthsystray.exe', 'nvcontainer.exe', 'adobecollabsync.exe', 'svchost.exe', 'coresync.exe', 'conhost.exe', 'brave.exe', 'svchost.exe', 'steamwebhelper.exe', 'brave.exe', 'adobe desktop service.exe', 'brave.exe', 'conhost.exe', 'runtimebroker.exe', 'airobin.exe', 'discord.exe', 'cephtmlengine.exe', 'brave.exe', 'systemsettingsbroker.exe', 'conhost.exe', 'brave.exe', 'brave.exe', 'brave.exe', 'searchindexer.exe', 'runtimebroker.exe', 'runtimebroker.exe', 'svchost.exe', 'nvdisplay.container.exe', 'conhost.exe', 'svchost.exe', 'telegram.exe', 'node.exe', 'msedge.exe', 'discord.exe', 'video.ui.exe', 'tabtip.exe', 'ctfmon.exe', 'microsoft.photos.exe', 'svchost.exe', 'msedge.exe', 'cephtmlengine.exe', 'brave.exe', 'wacom_tabletuser.exe', 'svchost.exe', 'svchost.exe', 'svchost.exe', 'widgets.exe', 'conhost.exe', 'svchost.exe', 'cephtmlengine.exe', 'jcef_helper.exe', 'mpcopyaccelerator.exe', 'runtimebroker.exe', 'runtimebroker.exe', 'cephtmlengine.exe', 'winlogon.exe', 'svchost.exe', 'msedge.exe', 'creative cloud helper.exe', 'svchost.exe', 'creative cloud helper.exe', 'msedgewebview2.exe', 'sgrmbroker.exe', 'steamwebhelper.exe', 'brave.exe', 'svchost.exe', 'runtimebroker.exe', 'python.exe', 'discord.exe', 'steamwebhelper.exe', 'jcef_helper.exe', 'brave.exe', 'acrobatnotificationclient.exe', 'nvcontainer.exe', 'wacom_tablet.exe', 'msedgewebview2.exe', 'chromedriver.exe', 'nvidia share.exe', 'chromedriver.exe', 'wallpaper32.exe', 'chromedriver.exe', 'bravecrashhandler64.exe', 'sppextcomobj.exe', 'taskhostw.exe', 'applicationframehost.exe', 'chromedriver.exe', 'brave.exe', 'cephtmlengine.exe', 'svchost.exe', 'msedge.exe', 'runtimebroker.exe', 'cclibrary.exe', 'msedgewebview2.exe', 'nvidia share.exe', 'steamwebhelper.exe', 'nvsphelper64.exe', 'chromedriver.exe', 'chromedriver.exe', 'dllhost.exe', 'svchost.exe', 'svchost.exe', 'conhost.exe', 'wacom_touchuser.exe', 'jusched.exe', 'searchfilterhost.exe', 'discord.exe', 'conhost.exe', 'adobe cef helper.exe', 'chromedriver.exe', 'searchprotocolhost.exe', 'wmic.exe', 'conhost.exe', 'brave.exe', 'googlecrashhandler64.exe', 'brave.exe', 'discord.exe', 'svchost.exe', 'brave.exe', 'conhost.exe', 'systemsettings.exe', 'brave.exe', 'cephtmlengine.exe', 'brave.exe', 'wmiprvse.exe', 'searchhost.exe', 'runtimebroker.exe', 'brave.exe', 'dataexchangehost.exe', 'chromedriver.exe', 'startmenuexperiencehost.exe', 'runtimebroker.exe', 'cephtmlengine.exe', 'svchost.exe', 'msedgewebview2.exe', 'pycharm64.exe', 'brave.exe', 'conhost.exe', 'msedgewebview2.exe', 'acrotray.exe', 'svchost.exe', 'conhost.exe', 'cephtmlengine.exe', 'runtimebroker.exe', 'wacom_updateutil.exe', 'conhost.exe', 'powershell.exe', 'steamwebhelper.exe', 'svchost.exe', 'sihost.exe', 'python.exe', 'jcef_helper.exe', 'adobeipcbroker.exe', 'brave.exe', 'msedge.exe', 'textinputhost.exe', 'jcef_helper.exe', 'conhost.exe', 'nvidia share.exe', 'cephtmlengine.exe', 'node.exe', 'steamwebhelper.exe', 'conhost.exe', 'explorer.exe', 'adobe cef helper.exe', 'brave.exe', 'adobenotificationclient.exe', 'brave.exe']
